command	main	sub
d3	Core	base
d3.select	Core	Selections
d3.selectAll	Core	Selections
selection.attr	Core	Selections
selection.classed	Core	Selections
selection.style	Core	Selections
selection.property	Core	Selections
selection.text	Core	Selections
selection.html	Core	Selections
selection.append	Core	Selections
selection.insert	Core	Selections
selection.remove	Core	Selections
selection.data	Core	Selections
selection.enter	Core	Selections
selection.exit	Core	Selections
selection.datum	Core	Selections
selection.filter	Core	Selections
selection.sort	Core	Selections
selection.order	Core	Selections
selection.on	Core	Selections
selection.transition	Core	Selections
selection.interrupt	Core	Selections
selection.each	Core	Selections
selection.call	Core	Selections
selection.empty	Core	Selections
selection.node	Core	Selections
selection.size	Core	Selections
selection.select	Core	Selections
selection.selectAll	Core	Selections
d3.selection	Core	Selections
d3.event	Core	Selections
d3.mouse	Core	Selections
d3.touch	Core	Selections
d3.touches	Core	Selections
d3.transition	Core	Transitions
transition.delay	Core	Transitions
transition.duration	Core	Transitions
transition.ease	Core	Transitions
transition.attr	Core	Transitions
transition.attrTween	Core	Transitions
transition.style	Core	Transitions
transition.styleTween	Core	Transitions
transition.text	Core	Transitions
transition.tween	Core	Transitions
transition.select	Core	Transitions
transition.selectAll	Core	Transitions
transition.filter	Core	Transitions
transition.transition	Core	Transitions
transition.remove	Core	Transitions
transition.empty	Core	Transitions
transition.node	Core	Transitions
transition.size	Core	Transitions
transition.each	Core	Transitions
transition.call	Core	Transitions
d3.ease	Core	Transitions
ease	Core	Transitions
d3.timer	Core	Transitions
d3.timer.flush	Core	Transitions
d3.interpolate	Core	Transitions
interpolate	Core	Transitions
d3.interpolateNumber	Core	Transitions
d3.interpolateRound	Core	Transitions
d3.interpolateString	Core	Transitions
d3.interpolateRgb	Core	Transitions
d3.interpolateHsl	Core	Transitions
d3.interpolateLab	Core	Transitions
d3.interpolateHcl	Core	Transitions
d3.interpolateArray	Core	Transitions
d3.interpolateObject	Core	Transitions
d3.interpolateTransform	Core	Transitions
d3.interpolateZoom	Core	Transitions
d3.interpolators	Core	Transitions
d3.ascending	Core	Working with Arrays
d3.descending	Core	Working with Arrays
d3.min	Core	Working with Arrays
d3.max	Core	Working with Arrays
d3.extent	Core	Working with Arrays
d3.sum	Core	Working with Arrays
d3.mean	Core	Working with Arrays
d3.median	Core	Working with Arrays
d3.quantile	Core	Working with Arrays
d3.bisect	Core	Working with Arrays
d3.bisectRight	Core	Working with Arrays
d3.bisectLeft	Core	Working with Arrays
d3.bisector	Core	Working with Arrays
d3.shuffle	Core	Working with Arrays
d3.permute	Core	Working with Arrays
d3.zip	Core	Working with Arrays
d3.transpose	Core	Working with Arrays
d3.pairs	Core	Working with Arrays
d3.keys	Core	Working with Arrays
d3.values	Core	Working with Arrays
d3.entries	Core	Working with Arrays
d3.merge	Core	Working with Arrays
d3.range	Core	Working with Arrays
d3.nest	Core	Working with Arrays
nest.key	Core	Working with Arrays
nest.sortKeys	Core	Working with Arrays
nest.sortValues	Core	Working with Arrays
nest.rollup	Core	Working with Arrays
nest.map	Core	Working with Arrays
nest.entries	Core	Working with Arrays
d3.map	Core	Working with Arrays
map.has	Core	Working with Arrays
map.get	Core	Working with Arrays
map.set	Core	Working with Arrays
map.remove	Core	Working with Arrays
map.keys	Core	Working with Arrays
map.values	Core	Working with Arrays
map.entries	Core	Working with Arrays
map.forEach	Core	Working with Arrays
map.empty	Core	Working with Arrays
map.size	Core	Working with Arrays
d3.set	Core	Working with Arrays
set.has	Core	Working with Arrays
set.add	Core	Working with Arrays
set.remove	Core	Working with Arrays
set.values	Core	Working with Arrays
set.forEach	Core	Working with Arrays
set.empty	Core	Working with Arrays
set.size	Core	Working with Arrays
d3.random.normal	Core	Math
d3.random.logNormal	Core	Math
d3.random.bates	Core	Math
d3.random.irwinHall	Core	Math
d3.transform	Core	Math
d3.xhr	Core	Loading External Resources
xhr.header	Core	Loading External Resources
xhr.mimeType	Core	Loading External Resources
xhr.response	Core	Loading External Resources
xhr.get	Core	Loading External Resources
xhr.post	Core	Loading External Resources
xhr.send	Core	Loading External Resources
xhr.abort	Core	Loading External Resources
xhr.on	Core	Loading External Resources
d3.text	Core	Loading External Resources
d3.json	Core	Loading External Resources
d3.html	Core	Loading External Resources
d3.xml	Core	Loading External Resources
d3.csv	Core	Loading External Resources
d3.tsv	Core	Loading External Resources
d3.format	Core	String Formatting
SI prefix	Core	String Formatting
d3.requote	Core	String Formatting
d3.round	Core	String Formatting
d3.csv.parse	Core	CSV Formatting
d3.csv.parseRows	Core	CSV Formatting
d3.csv.format	Core	CSV Formatting
d3.csv.formatRows	Core	CSV Formatting
d3.tsv.parse	Core	CSV Formatting
d3.tsv.parseRows	Core	CSV Formatting
d3.tsv.format	Core	CSV Formatting
d3.tsv.formatRows	Core	CSV Formatting
d3.dsv	Core	CSV Formatting
d3.locale	Core	Localization
locale.numberFormat	Core	Localization
locale.timeFormat	Core	Localization
d3.rgb	Core	Colors
rgb.brighter	Core	Colors
rgb.darker	Core	Colors
rgb.hsl	Core	Colors
rgb.toString	Core	Colors
d3.hsl	Core	Colors
hsl.brighter	Core	Colors
hsl.darker	Core	Colors
hsl.rgb	Core	Colors
hsl.toString	Core	Colors
d3.lab	Core	Colors
lab.brighter	Core	Colors
lab.darker	Core	Colors
lab.rgb	Core	Colors
lab.toString	Core	Colors
d3.hcl	Core	Colors
hcl.brighter	Core	Colors
hcl.darker	Core	Colors
hcl.rgb	Core	Colors
hcl.toString	Core	Colors
d3.ns.prefix	Core	Namespaces
d3.ns.qualify	Core	Namespaces
d3.functor	Core	Internals
d3.rebind	Core	Internals
d3.dispatch	Core	Internals
dispatch.on	Core	Internals
dispatch.type	Core	Internals
d3.scale	Scales	base
d3.scale.linear	Scales	Quantitative
linear	Scales	Quantitative
linear.invert	Scales	Quantitative
linear.domain	Scales	Quantitative
linear.range	Scales	Quantitative
linear.rangeRound	Scales	Quantitative
linear.interpolate	Scales	Quantitative
linear.clamp	Scales	Quantitative
linear.nice	Scales	Quantitative
linear.ticks	Scales	Quantitative
linear.tickFormat	Scales	Quantitative
linear.copy	Scales	Quantitative
d3.scale.sqrt	Scales	Quantitative
d3.scale.pow	Scales	Quantitative
pow	Scales	Quantitative
pow.invert	Scales	Quantitative
pow.domain	Scales	Quantitative
pow.range	Scales	Quantitative
pow.rangeRound	Scales	Quantitative
pow.interpolate	Scales	Quantitative
pow.clamp	Scales	Quantitative
pow.nice	Scales	Quantitative
pow.ticks	Scales	Quantitative
pow.tickFormat	Scales	Quantitative
pow.exponent	Scales	Quantitative
pow.copy	Scales	Quantitative
d3.scale.log	Scales	Quantitative
log	Scales	Quantitative
log.invert	Scales	Quantitative
log.domain	Scales	Quantitative
log.range	Scales	Quantitative
log.rangeRound	Scales	Quantitative
log.interpolate	Scales	Quantitative
log.clamp	Scales	Quantitative
log.nice	Scales	Quantitative
log.ticks	Scales	Quantitative
log.tickFormat	Scales	Quantitative
log.copy	Scales	Quantitative
d3.scale.quantize	Scales	Quantitative
quantize	Scales	Quantitative
quantize.invertExtent	Scales	Quantitative
quantize.domain	Scales	Quantitative
quantize.range	Scales	Quantitative
quantize.copy	Scales	Quantitative
d3.scale.threshold	Scales	Quantitative
threshold	Scales	Quantitative
threshold.invertExtent	Scales	Quantitative
threshold.domain	Scales	Quantitative
threshold.range	Scales	Quantitative
threshold.copy	Scales	Quantitative
d3.scale.quantile	Scales	Quantitative
quantile	Scales	Quantitative
quantile.invertExtent	Scales	Quantitative
quantile.domain	Scales	Quantitative
quantile.range	Scales	Quantitative
quantile.quantiles	Scales	Quantitative
quantile.copy	Scales	Quantitative
d3.scale.identity	Scales	Quantitative
identity	Scales	Quantitative
identity.invert	Scales	Quantitative
identity.domain	Scales	Quantitative
identity.range	Scales	Quantitative
identity.ticks	Scales	Quantitative
identity.tickFormat	Scales	Quantitative
identity.copy	Scales	Quantitative
d3.scale.ordinal	Scales	Ordinal
ordinal	Scales	Ordinal
ordinal.domain	Scales	Ordinal
ordinal.range	Scales	Ordinal
ordinal.rangePoints	Scales	Ordinal
ordinal.rangeBands	Scales	Ordinal
ordinal.rangeRoundBands	Scales	Ordinal
ordinal.rangeBand	Scales	Ordinal
ordinal.rangeExtent	Scales	Ordinal
ordinal.copy	Scales	Ordinal
d3.scale.category10	Scales	Ordinal
d3.scale.category20	Scales	Ordinal
d3.scale.category20b	Scales	Ordinal
d3.scale.category20c	Scales	Ordinal
d3.svg	SVG	base
d3.svg.line	SVG	Shapes
line	SVG	Shapes
line.x	SVG	Shapes
line.y	SVG	Shapes
line.interpolate	SVG	Shapes
line.tension	SVG	Shapes
line.defined	SVG	Shapes
d3.svg.line.radial	SVG	Shapes
line	SVG	Shapes
line.radius	SVG	Shapes
line.angle	SVG	Shapes
line.defined	SVG	Shapes
d3.svg.area	SVG	Shapes
area	SVG	Shapes
area.x	SVG	Shapes
area.x0	SVG	Shapes
area.x1	SVG	Shapes
area.y	SVG	Shapes
area.y0	SVG	Shapes
area.y1	SVG	Shapes
area.interpolate	SVG	Shapes
area.tension	SVG	Shapes
area.defined	SVG	Shapes
d3.svg.area.radial	SVG	Shapes
area	SVG	Shapes
area.radius	SVG	Shapes
area.innerRadius	SVG	Shapes
area.outerRadius	SVG	Shapes
area.angle	SVG	Shapes
area.startAngle	SVG	Shapes
area.endAngle	SVG	Shapes
area.defined	SVG	Shapes
d3.svg.arc	SVG	Shapes
arc	SVG	Shapes
arc.innerRadius	SVG	Shapes
arc.outerRadius	SVG	Shapes
arc.startAngle	SVG	Shapes
arc.endAngle	SVG	Shapes
arc.centroid	SVG	Shapes
d3.svg.symbol	SVG	Shapes
symbol	SVG	Shapes
symbol.type	SVG	Shapes
symbol.size	SVG	Shapes
d3.svg.symbolTypes	SVG	Shapes
d3.svg.chord	SVG	Shapes
chord	SVG	Shapes
chord.radius	SVG	Shapes
chord.startAngle	SVG	Shapes
chord.endAngle	SVG	Shapes
chord.source	SVG	Shapes
chord.target	SVG	Shapes
d3.svg.diagonal	SVG	Shapes
diagonal	SVG	Shapes
diagonal.source	SVG	Shapes
diagonal.target	SVG	Shapes
diagonal.projection	SVG	Shapes
d3.svg.diagonal.radial	SVG	Shapes
diagonal	SVG	Shapes
d3.svg.axis	SVG	Axes
axis	SVG	Axes
axis.scale	SVG	Axes
axis.orient	SVG	Axes
axis.ticks	SVG	Axes
axis.tickValues	SVG	Axes
axis.tickSize	SVG	Axes
axis.innerTickSize	SVG	Axes
axis.outerTickSize	SVG	Axes
axis.tickPadding	SVG	Axes
axis.tickFormat	SVG	Axes
d3.svg.brush	SVG	SVG-Controls
brush	SVG	SVG-Controls
brush.x	SVG	SVG-Controls
brush.y	SVG	SVG-Controls
brush.extent	SVG	SVG-Controls
brush.clear	SVG	SVG-Controls
brush.empty	SVG	SVG-Controls
brush.on	SVG	SVG-Controls
brush.event	SVG	SVG-Controls
d3.time	Time	base
d3.time.format	Time	Time Formatting
format	Time	Time Formatting
format.parse	Time	Time Formatting
d3.time.format.multi	Time	Time Formatting
d3.time.format.utc	Time	Time Formatting
d3.time.format.iso	Time	Time Formatting
d3.time.scale	Time	Time Scales
scale	Time	Time Scales
scale.invert	Time	Time Scales
scale.domain	Time	Time Scales
scale.nice	Time	Time Scales
scale.range	Time	Time Scales
scale.rangeRound	Time	Time Scales
scale.interpolate	Time	Time Scales
scale.clamp	Time	Time Scales
scale.ticks	Time	Time Scales
scale.tickFormat	Time	Time Scales
scale.copy	Time	Time Scales
d3.time.interval	Time	Time Intervals
interval	Time	Time Intervals
interval.range	Time	Time Intervals
interval.floor	Time	Time Intervals
interval.round	Time	Time Intervals
interval.ceil	Time	Time Intervals
interval.offset	Time	Time Intervals
interval.utc	Time	Time Intervals
d3.time.day	Time	Time Intervals
d3.time.days	Time	Time Intervals
d3.time.dayOfYear	Time	Time Intervals
d3.time.hour	Time	Time Intervals
d3.time.hours	Time	Time Intervals
d3.time.minute	Time	Time Intervals
d3.time.minutes	Time	Time Intervals
d3.time.month	Time	Time Intervals
d3.time.months	Time	Time Intervals
d3.time.second	Time	Time Intervals
d3.time.seconds	Time	Time Intervals
d3.time.sunday	Time	Time Intervals
d3.time.sundays	Time	Time Intervals
d3.time.sundayOfYear	Time	Time Intervals
d3.time.monday	Time	Time Intervals
d3.time.mondays	Time	Time Intervals
d3.time.mondayOfYear	Time	Time Intervals
d3.time.tuesday	Time	Time Intervals
d3.time.tuesdays	Time	Time Intervals
d3.time.tuesdayOfYear	Time	Time Intervals
d3.time.wednesday	Time	Time Intervals
d3.time.wednesdays	Time	Time Intervals
d3.time.wednesdayOfYear	Time	Time Intervals
d3.time.thursday	Time	Time Intervals
d3.time.thursdays	Time	Time Intervals
d3.time.thursdayOfYear	Time	Time Intervals
d3.time.friday	Time	Time Intervals
d3.time.fridays	Time	Time Intervals
d3.time.fridayOfYear	Time	Time Intervals
d3.time.saturday	Time	Time Intervals
d3.time.saturdays	Time	Time Intervals
d3.time.saturdayOfYear	Time	Time Intervals
d3.time.week	Time	Time Intervals
d3.time.weeks	Time	Time Intervals
d3.time.weekOfYear	Time	Time Intervals
d3.time.year	Time	Time Intervals
d3.time.years	Time	Time Intervals
d3.layout	Layouts	base
d3.layout.bundle	Layouts	Bundle
bundle	Layouts	Bundle
d3.layout.chord	Layouts	Chord
chord.matrix	Layouts	Chord
chord.padding	Layouts	Chord
chord.sortGroups	Layouts	Chord
chord.sortSubgroups	Layouts	Chord
chord.sortChords	Layouts	Chord
chord.chords	Layouts	Chord
chord.groups	Layouts	Chord
d3.layout.cluster	Layouts	Cluster-Layout
cluster	Layouts	Cluster-Layout
cluster.nodes	Layouts	Cluster-Layout
cluster.links	Layouts	Cluster-Layout
cluster.children	Layouts	Cluster-Layout
cluster.sort	Layouts	Cluster-Layout
cluster.separation	Layouts	Cluster-Layout
cluster.size	Layouts	Cluster-Layout
cluster.nodeSize	Layouts	Cluster-Layout
d3.layout.force	Layouts	Force
force.on	Layouts	Force
force.nodes	Layouts	Force
force.links	Layouts	Force
force.size	Layouts	Force
force.linkDistance	Layouts	Force
force.linkStrength	Layouts	Force
force.friction	Layouts	Force
force.charge	Layouts	Force
force.chargeDistance	Layouts	Force
force.gravity	Layouts	Force
force.theta	Layouts	Force
force.start	Layouts	Force
force.resume	Layouts	Force
force.stop	Layouts	Force
force.alpha	Layouts	Force
force.tick	Layouts	Force
force.drag	Layouts	Force
d3.layout.hierarchy	Layouts	Hierarchy-Layout
hierarchy	Layouts	Hierarchy-Layout
hierarchy.nodes	Layouts	Hierarchy-Layout
hierarchy.links	Layouts	Hierarchy-Layout
hierarchy.children	Layouts	Hierarchy-Layout
hierarchy.sort	Layouts	Hierarchy-Layout
hierarchy.value	Layouts	Hierarchy-Layout
hierarchy.revalue	Layouts	Hierarchy-Layout
d3.layout.histogram	Layouts	Histogram
histogram	Layouts	Histogram
histogram.value	Layouts	Histogram
histogram.range	Layouts	Histogram
histogram.bins	Layouts	Histogram
histogram.frequency	Layouts	Histogram
d3.layout.pack	Layouts	Pack-Layout
pack	Layouts	Pack-Layout
pack.nodes	Layouts	Pack-Layout
pack.links	Layouts	Pack-Layout
pack.children	Layouts	Pack-Layout
pack.sort	Layouts	Pack-Layout
pack.value	Layouts	Pack-Layout
pack.size	Layouts	Pack-Layout
pack.radius	Layouts	Pack-Layout
pack.padding	Layouts	Pack-Layout
d3.layout.partition	Layouts	Partition-Layout
partition	Layouts	Partition-Layout
partition.nodes	Layouts	Partition-Layout
partition.links	Layouts	Partition-Layout
partition.children	Layouts	Partition-Layout
partition.sort	Layouts	Partition-Layout
partition.value	Layouts	Partition-Layout
partition.size	Layouts	Partition-Layout
d3.layout.pie	Layouts	Pie
pie	Layouts	Pie
pie.value	Layouts	Pie
pie.sort	Layouts	Pie
pie.startAngle	Layouts	Pie
pie.endAngle	Layouts	Pie
d3.layout.stack	Layouts	Stack
stack	Layouts	Stack
stack.values	Layouts	Stack
stack.order	Layouts	Stack
stack.offset	Layouts	Stack
stack.x	Layouts	Stack
stack.y	Layouts	Stack
stack.out	Layouts	Stack
d3.layout.tree	Layouts	Tree-Layout
tree	Layouts	Tree-Layout
tree.nodes	Layouts	Tree-Layout
tree.links	Layouts	Tree-Layout
tree.children	Layouts	Tree-Layout
tree.sort	Layouts	Tree-Layout
tree.separation	Layouts	Tree-Layout
tree.size	Layouts	Tree-Layout
tree.nodeSize	Layouts	Tree-Layout
d3.layout.treemap	Layouts	Treemap-Layout
treemap	Layouts	Treemap-Layout
treemap.nodes	Layouts	Treemap-Layout
treemap.links	Layouts	Treemap-Layout
treemap.children	Layouts	Treemap-Layout
treemap.sort	Layouts	Treemap-Layout
treemap.value	Layouts	Treemap-Layout
treemap.size	Layouts	Treemap-Layout
treemap.padding	Layouts	Treemap-Layout
treemap.round	Layouts	Treemap-Layout
treemap.sticky	Layouts	Treemap-Layout
treemap.mode	Layouts	Treemap-Layout
d3.geo	Geo	base
d3.geo.path	Geo	Geo-Paths
path	Geo	Geo-Paths
path.projection	Geo	Geo-Paths
path.context	Geo	Geo-Paths
path.pointRadius	Geo	Geo-Paths
path.area	Geo	Geo-Paths
path.centroid	Geo	Geo-Paths
path.bounds	Geo	Geo-Paths
d3.geo.graticule	Geo	Geo-Paths
graticule	Geo	Geo-Paths
graticule.lines	Geo	Geo-Paths
graticule.outline	Geo	Geo-Paths
graticule.extent	Geo	Geo-Paths
graticule.majorExtent	Geo	Geo-Paths
graticule.minorExtent	Geo	Geo-Paths
graticule.step	Geo	Geo-Paths
graticule.majorStep	Geo	Geo-Paths
graticule.minorStep	Geo	Geo-Paths
graticule.precision	Geo	Geo-Paths
d3.geo.circle	Geo	Geo-Paths
circle	Geo	Geo-Paths
circle.origin	Geo	Geo-Paths
circle.angle	Geo	Geo-Paths
circle.precision	Geo	Geo-Paths
d3.geo.area	Geo	Geo-Paths
d3.geo.bounds	Geo	Geo-Paths
d3.geo.centroid	Geo	Geo-Paths
d3.geo.distance	Geo	Geo-Paths
d3.geo.interpolate	Geo	Geo-Paths
d3.geo.length	Geo	Geo-Paths
λ, φ, γ	Geo	Geo-Paths
rotation	Geo	Geo-Paths
rotation.invert	Geo	Geo-Paths
d3.geo.projection	Geo	Projections
projection	Geo	Projections
projection.invert	Geo	Projections
projection.rotate	Geo	Projections
projection.center	Geo	Projections
projection.translate	Geo	Projections
projection.scale	Geo	Projections
projection.clipAngle	Geo	Projections
projection.clipExtent	Geo	Projections
projection.precision	Geo	Projections
projection.stream	Geo	Projections
d3.geo.projectionMutator	Geo	Projections
d3.geo.albers	Geo	Projections
albers.parallels	Geo	Projections
d3.geo.albersUsa	Geo	Projections
d3.geo.azimuthalEqualArea	Geo	Projections
d3.geo.azimuthalEquidistant	Geo	Projections
d3.geo.conicConformal	Geo	Projections
d3.geo.conicEquidistant	Geo	Projections
d3.geo.conicEqualArea	Geo	Projections
d3.geo.equirectangular	Geo	Projections
d3.geo.gnomonic	Geo	Projections
d3.geo.mercator	Geo	Projections
d3.geo.orthographic	Geo	Projections
d3.geo.stereographic	Geo	Projections
d3.geo.azimuthalEqualArea.raw	Geo	Projections
d3.geo.azimuthalEquidistant.raw	Geo	Projections
d3.geo.conicConformal.raw	Geo	Projections
d3.geo.conicEquidistant.raw	Geo	Projections
d3.geo.conicEqualArea.raw	Geo	Projections
d3.geo.equirectangular.raw	Geo	Projections
d3.geo.gnomonic.raw	Geo	Projections
d3.geo.mercator.raw	Geo	Projections
d3.geo.orthographic.raw	Geo	Projections
d3.geo.stereographic.raw	Geo	Projections
d3.geo.transverseMercator.raw	Geo	Projections
d3.geo.stream	Geo	Geo-Streams
stream.point	Geo	Geo-Streams
stream.lineStart	Geo	Geo-Streams
stream.lineEnd	Geo	Geo-Streams
stream.polygonStart	Geo	Geo-Streams
stream.polygonEnd	Geo	Geo-Streams
stream.sphere	Geo	Geo-Streams
d3.geo.transform	Geo	Geo-Streams
transform.stream	Geo	Geo-Streams
d3.geo.clipExtent	Geo	Geo-Streams
clipExtent.extent	Geo	Geo-Streams
d3.geom	Geometry	base
d3.geom.voronoi	Geometry	Voronoi
voronoi	Geometry	Voronoi
voronoi.x	Geometry	Voronoi
voronoi.y	Geometry	Voronoi
voronoi.clipExent	Geometry	Voronoi
voronoi.links	Geometry	Voronoi
voronoi.triangles	Geometry	Voronoi
d3.geom.quadtree	Geometry	Quadtree
quadtree.add	Geometry	Quadtree
quadtree.visit	Geometry	Quadtree
d3.geom.polygon	Geometry	Polygon
polygon.area	Geometry	Polygon
polygon.centroid	Geometry	Polygon
polygon.clip	Geometry	Polygon
d3.geom.hull	Geometry	Hull
hull	Geometry	Hull
hull.x	Geometry	Hull
hull.y	Geometry	Hull
d3.behavior	Core	base
d3.behavior.drag	Core	Drag
drag.origin	Core	Drag
drag.on	Core	Drag
d3.behavior.zoom	Core	Zoom-Behavior
zoom	Core	Zoom-Behavior
zoom.scale	Core	Zoom-Behavior
zoom.translate	Core	Zoom-Behavior
zoom.scaleExtent	Core	Zoom-Behavior
zoom.center	Core	Zoom-Behavior
zoom.size	Core	Zoom-Behavior
zoom.x	Core	Zoom-Behavior
zoom.y	Core	Zoom-Behavior
zoom.on	Core	Zoom-Behavior
zoom.event	Core	Zoom-Behavior
d3.geo.bonne	Geo	Plugin
d3.scale.category	Scales	Base
d3.formatPrefix	Core	Plugin
d3.geom.contour	Geometry	Plugin
d3.geo.kavrayskiy7	Geo	Plugin
d3.geo.naturalEarth	Geo	Plugin
d3.geo.cylindricalEqualArea	Geo	Plugin
d3.geo.hammer	Geo	Plugin
d3.geo.mollweide	Geo	Plugin
d3.geo.aitoff	Geo	Plugin
d3.geo.vanDerGrinten	Geo	Plugin
d3.geo.collignon	Geo	Plugin
d3.geo.eckert1	Geo	Plugin
d3.geo.eckert2	Geo	Plugin
d3.geo.eckert3	Geo	Plugin
d3.geo.eckert4	Geo	Plugin
d3.geo.eckert5	Geo	Plugin
d3.geo.eckert6	Geo	Plugin
d3.geo.homolosine	Geo	Plugin
d3.geo.larrivee	Geo	Plugin
d3.geo.miller	Geo	Plugin
d3.geo.nellHammer	Geo	Plugin
d3.geo.polyconic	Geo	Plugin
d3.geo.robinson	Geo	Plugin
d3.geo.sinusoidal	Geo	Plugin
d3.geo.wagner6	Geo	Plugin
d3.geo.winkel3	Geo	Plugin
d3.geo.gringorten	Geo	Plugin
d3.geo.guyou	Geo	Plugin
d3.geo.hammerRetroazimuthal	Geo	Plugin
d3.geo.vanDerGrinten4	Geo	Plugin
d3.geo.august	Geo	Plugin
d3.geo.baker	Geo	Plugin
d3.geo.berghaus	Geo	Plugin
d3.geo.boggs	Geo	Plugin
d3.geo.bromley	Geo	Plugin
d3.geo.craster	Geo	Plugin
d3.geo.eisenlohr	Geo	Plugin
d3.geo.healpix	Geo	Plugin
d3.geo.hill	Geo	Plugin
d3.geo.lagrange	Geo	Plugin
d3.geo.laskowski	Geo	Plugin
d3.geo.loximuthal	Geo	Plugin
d3.geo.mtFlatPolarParabolic	Geo	Plugin
d3.geo.mtFlatPolarQuartic	Geo	Plugin
d3.geo.mtFlatPolarSinusoidal	Geo	Plugin
d3.geo.sinuMollweide	Geo	Plugin
d3.geo.wagner4	Geo	Plugin
d3.geo.wagner7	Geo	Plugin
d3.geo.satellite	Geo	Plugin
d3.geo.craig	Geo	Plugin
d3.geo.armadillo	Geo	Plugin
d3.geo.littrow	Geo	Plugin
d3.geo.peirceQuincuncial	Geo	Plugin
d3.geo.polyhedron	Geo	Plugin
d3.geo.wiechel	Geo	Plugin
d3.geo.polyhedron.waterman	Geo	Plugin
d3.geo.times	Geo	Plugin
d3.geo.cylindricalStereographic	Geo	Plugin
d3.geo.fahey	Geo	Plugin
d3.geo.ginzburg4	Geo	Plugin
d3.geo.ginzburg5	Geo	Plugin
d3.geo.ginzburg6	Geo	Plugin
d3.geo.ginzburg8	Geo	Plugin
d3.geo.ginzburg9	Geo	Plugin
d3.geo.rectangularPolyconic	Geo	Plugin
d3.geo.vanDerGrinten2	Geo	Plugin
d3.geo.vanDerGrinten3	Geo	Plugin
d3.fisheye	Plugin	Plugin
d3.hexbin	Plugin	Plugin
d3.box	Plugin	Plugin
d3.geo.transverseMercator	Geo	Plugin
d3.geo.tile	Geo	Plugin
d3.force_labels	Plugin	Plugin
d3.sankey	Plugin	Plugin
d3.horizon	Plugin	Plugin
d3.bullet	Plugin	Plugin
d3.geodesic	Plugin	Plugin
d3.geo.rotation	Geo	Plugin
d3.geo.twoPointEquidistant	Geo	Plugin
d3.geo.airy	Geo	Plugin
d3.geo.chamberlin	Geo	Plugin
d3.geo.polyhedron.butterfly	Geo	Plugin
d3.hive	Plugin	Plugin
d3.rollup	Plugin	Plugin
d3.superformula	Plugin	Plugin
d3.qq	Plugin	Plugin
d3.longscroll	Plugin	Plugin